beta_lactamase_family	Specify the beta-lactamase family for this gene.	['', 'ACC', 'ACT', 'ADC', 'BEL', 'CARB', 'CBP', 'CFE', 'CMY', 'CTX-M', 'DHA', 'FOX', 'GES', 'GIM', 'KPC', 'IMI', 'IMP', 'IND', 'LAT', 'MIR', 'MOX', 'NDM', 'OXA', 'PER', 'PDC', 'SHV', 'SME', 'TEM', 'VEB', 'VIM', 'unknown']	Beta-lactamase.1.0
biotic_relationship	Free-living or from host (define relationship)	['', 'free living', 'parasite', 'commensal', 'symbiont']	
build_occup_type	primary function for which a building or discrete part of a building is intended to be used	['', 'office', 'market', 'restaurant', 'residence', 'school', 'residential', 'commercial', 'low rise', 'high rise', 'wood framed', 'health care', 'airport', 'sports complex', 'missing', 'not applicable', 'not collected']	MIMS.me.built.4.0,MIGS.ba.built.4.0,MIGS.eu.built.4.0,MIGS.vi.built.4.0,MIMARKS.specimen.built.4.0,MIMARKS.survey.built.4.0
building_setting	location (geography) where a building is set	['', 'urban', 'suburban', 'exurban', 'rural', 'missing', 'not applicable', 'not collected']	MIMS.me.built.4.0,MIGS.ba.built.4.0,MIGS.eu.built.4.0,MIGS.vi.built.4.0,MIMARKS.specimen.built.4.0,MIMARKS.survey.built.4.0
carbapenemase	Does the enzyme exhibit carbapenemase activity? If the enzyme does exhibit carbapenemase activity, the response should be "yes", otherwise "no."	['', 'yes', 'no', 'missing', 'not applicable', 'not collected']	Beta-lactamase.1.0
cur_land_use	present state of sample site	['', 'cities', 'farmstead', 'industrial areas', 'roads/railroads', 'rock', 'sand', 'gravel', 'mudflats', 'salt flats', 'badlands', 'permanent snow or ice', 'saline seeps', 'mines/quarries', 'oil waste areas', 'small grains', 'row crops', 'vegetable crops', 'horticultural plants (e.g. tulips)', 'marshlands (grass,sedges,rushes)', 'tundra (mosses,lichens)', 'rangeland', 'pastureland (grasslands used for livestock grazing)', 'hayland', 'meadows (grasses,alfalfa,fescue,bromegrass,timothy)', 'shrub land (e.g. mesquite,sage-brush,creosote bush,shrub oak,eucalyptus)', 'successional shrub land (tree saplings,hazels,sumacs,chokecherry,shrub dogwoods,blackberries)', 'shrub crops (blueberries,nursery ornamentals,filberts)', 'vine crops (grapes)', 'conifers (e.g. pine,spruce,fir,cypress)', 'hardwoods (e.g. oak,hickory,elm,aspen)', 'intermixed hardwood and conifers', 'tropical (e.g. mangrove,palms)', 'rainforest (evergreen forest receiving >406 cm annual rainfall)', 'swamp (permanent or semi-permanent water body dominated by woody plants)', 'crop trees (nuts,fruit,christmas trees,nursery trees)']	
dominant_hand	dominant hand of the subject	['', 'left', 'right', 'ambidextrous']	
drainage_class	drainage classification from a standard system such as the USDA system	['', 'very poorly', 'poorly', 'somewhat poorly', 'moderately well', 'well', 'excessively drained']	
edta_inhibitor_tested	Was carbapenemase activity tested in the presence of EDTA? If carbapenemase activity was tested in the presence of EDTA, the response should be "yes", otherwise "no‚Äù.	['', 'yes', 'no', 'missing', 'not applicable', 'not collected']	Beta-lactamase.1.0
filter_type	device which removes solid particulates or airborne molecular contaminants	['', 'particulate air filter', 'chemical air filter', 'low-MERV pleated media', 'HEPA', 'electrostatic', 'gas-phase or ultraviolet air treatments', 'missing', 'not applicable', 'not collected']	MIMS.me.built.4.0,MIGS.ba.built.4.0,MIGS.eu.built.4.0,MIGS.vi.built.4.0,MIMARKS.specimen.built.4.0,MIMARKS.survey.built.4.0
growth_med	information about growth media for growing the plants or tissue cultured samples	['', 'soil', 'liquid']	
heat_cool_type	methods of conditioning or heating a room or building	['', 'radiant system', 'heat pump', 'forced air system', 'steam forced heat', 'wood stove', 'missing', 'not applicable', 'not collected']	MIMS.me.built.4.0,MIGS.ba.built.4.0,MIGS.eu.built.4.0,MIGS.vi.built.4.0,MIMARKS.specimen.built.4.0,MIMARKS.survey.built.4.0
horizon	specific layer in the land area which measures parallel to the soil surface and possesses physical characteristics which differ from the layers above and beneath	['', 'O horizon', 'A horizon', 'E horizon', 'B horizon', 'C horizon', 'R layer', 'Permafrost']	
host_sex	Gender or physical sex of the host	['', 'male', 'female', 'pooled male and female', 'neuter', 'hermaphrodite', 'intersex', 'not determined', 'missing', 'not applicable', 'not collected']	
indoor_space	a distinguishable space within a structure, the purpose for which discrete areas of a building is used	['', 'bedroom', 'office', 'bathroom', 'foyer', 'kitchen', 'locker room', 'hallway', 'elevator', 'missing', 'not applicable', 'not collected']	MIMS.me.built.4.0,MIGS.ba.built.4.0,MIGS.eu.built.4.0,MIGS.vi.built.4.0,MIMARKS.specimen.built.4.0,MIMARKS.survey.built.4.0
indoor_surf	type of indoor surface	['', 'counter top', 'window', 'wall', 'cabinet', 'ceiling', 'door', 'shelving', 'vent cover']	
investigation_type	Nucleic Acid Sequence Report is the root element of all MIGS/MIMS compliant reports as standardized by Genomic Standards Consortium. This field is either eukaryote,bacteria,virus,plasmid,organelle, metagenome, miens-survey or miens-culture	['', 'eukaryote', 'bacteria_archaea', 'plasmid', 'virus', 'organelle', 'metagenome', 'miens-survey', 'miens-culture']	
light_type	application of light to achieve some practical or aesthetic effect. Lighting includes the use of both artificial light sources such as lamps and light fixtures, as well as natural illumination by capturing daylight. Can also include absence of light	['', 'natural light', 'electric light', 'no light', 'missing', 'not applicable', 'not collected']	MIMS.me.built.4.0,MIGS.ba.built.4.0,MIGS.eu.built.4.0,MIGS.vi.built.4.0,MIMARKS.specimen.built.4.0,MIMARKS.survey.built.4.0
oxy_stat_samp	oxygenation status of sample	['', 'aerobic', 'anaerobic']	
profile_position	cross-sectional position in the hillslope where sample was collected, sample area position in relation to surrounding areas	['', 'summit', 'shoulder', 'backslope', 'footslope', 'toeslope']	
rel_to_oxygen	Aerobic or anaerobic	['', 'aerobe', 'anaerobe', 'facultative', 'microaerophilic', 'microanaerobe', 'obligate aerobe', 'obligate anaerobe']	
sediment_type	information about the sediment type based on major constituents	['', 'biogenous', 'cosmogenous', 'hydrogenous', 'lithogenous']	
sex	physical sex of sampled organism	['', 'male', 'female', 'pooled male and female', 'neuter', 'hermaphrodite', 'intersex', 'not determined', 'missing', 'not applicable', 'not collected']	Model.organism.animal.1.0,Human.1.0
space_typ_state	customary or normal state of the space	['', 'typical occupied', 'typically unoccupied', 'missing', 'not applicable', 'not collected']	MIMS.me.built.4.0,MIGS.ba.built.4.0,MIGS.eu.built.4.0,MIGS.vi.built.4.0,MIMARKS.specimen.built.4.0,MIMARKS.survey.built.4.0
special_diet	specification of special diet; can include multiple special diets	['', 'low carb', 'reduced calorie', 'vegetarian', 'other(to be specified)']	
substructure_type	substructure or under building is that largely hidden section of the building which is built off the foundations to the ground floor level	['', 'crawlspace', 'slab on grade', 'basement']	
super_population_code	The 3 letter super population abbreviation from the Coriell Institute indicating ancestry	['', 'AFR', 'AMR', 'EAS', 'EUR', 'SAS']	
super_population_description	The full, unabbreviated super population descriptor from the Coriell Institute	['', 'African', 'Ad Mixed American', 'East Asian', 'European', 'South Asian']	
surf_air_cont	contaminant identified on surface	['', 'dust', 'organic matter', 'particulate matter', 'volatile organic compounds', 'biological contaminants', 'radon', 'nutrients', 'biocides']	
surf_material	surface materials at the point of sampling	['', 'concrete', 'wood', 'stone', 'tile', 'plastic', 'glass', 'vinyl', 'metal', 'carpet', 'stainless steel', 'paint', 'cinder blocks', 'hay bales', 'stucco', 'adobe']	
tidal_stage	stage of tide	['', 'low', 'high']	
tillage	note method(s) used for tilling	['', 'drill', 'cutting disc', 'ridge till', 'strip tillage', 'zonal tillage', 'chisel', 'tined', 'mouldboard', 'disc plough']	
trophic_level	Feeding position in food chain (eg., chemolithotroph)	['', 'autotroph', 'carboxydotroph', 'chemoautotroph', 'chemoheterotroph', 'chemolithoautotroph', 'chemolithotroph', 'chemoorganoheterotroph', 'chemoorganotroph', 'chemosynthetic', 'chemotroph', 'copiotroph', 'diazotroph', 'facultative', 'heterotroph', 'lithoautotroph', 'lithoheterotroph', 'lithotroph', 'methanotroph', 'methylotroph', 'mixotroph', 'obligate', 'chemoautolithotroph', 'oligotroph', 'organoheterotroph', 'organotroph', 'photoautotroph', 'photoheterotroph', 'photolithoautotroph', 'photolithotroph', 'photosynthetic', 'phototroph']	
urine_collect_meth	specification of urine collection method	['', 'clean catch', 'catheter']	
